11111111
10P01C01
101E0001
10111000
1C000001
11111111