11111111
10P01C01
101E0001
10111001
1C0000E1
11111111