11111111
10P011C1
101E0011
10111001
1C000001
11111111