111111111111111111111111111111111111111111111111111
100000000000011000000000000000000000000000000000001
100001C0000000000E000000000000000000000000000000001
100000100000010000000000000000000000000000000000001
1000000010000000000P0000010000000000000000000000001
100000100000010000000000000000000000000000000000001
100000000000000000000000000000000000000000000000001
100000100000000000100000000000000000000000000000001
100011000000000000110000011000000000000000000000001
1000001000C0010000010000000000000000000000000000001
100000100000011000100000000110000000000000000000001
100011000000000000110000011000000000000000000000001
100000000001100000000000011000000000000000000000001
100011000001100000000000000000000000000000000000001
100000000000100C00000000001000000000000000000000001
100100000000000001000000100000000000000000000000001
100000000010000000000000100000000000000000000000001
100100000010000000000000000000000000000000000000001
100000000000000000000000000000000000000000000000001
100000000000000000000000000000000000000000000000001
100000000000000000000000000000000000000000000000001
100000000000000000000000000000000000000000000000001
100000000000000000000000000000000000000000000000001
100000000000000000000000000000000000000000000000001
100000000000000000000000000000000000000000000000001
111111111111111111111111111111111111111111111111111